1,1,1,1,1,1,1,1,1,5,1,1,1,1,1,1,1,1,1,1
1,0,0,0,0,0,B,0,0,5,0,0,0,0,0,0,0,0,0,1
1,0,1,1,1,1,1,1,1,5,1,1,1,1,1,0,1,1,0,1
1,0,1,0,0,0,0,0,0,5,0,0,0,0,0,0,0,1,0,1
1,0,1,1,0,1,1,1,1,5,1,1,1,1,1,1,1,1,0,1
1,0,0,0,0,0,0,0,0,5,0,0,0,0,0,0,0,0,0,1
1,0,1,0,1,1,1,1,1,5,1,1,1,1,1,1,1,1,0,1
1,0,1,0,0,0,0,0,0,5,0,0,0,0,0,0,0,1,1,1
1,0,1,1,1,1,1,1,1,5,1,1,1,1,1,1,0,1,0,1
1,0,1,0,0,0,1,0,0,5,0,1,0,0,0,1,0,0,0,1
1,0,0,0,1,0,0,0,1,5,0,0,0,1,0,0,0,1,0,1
1,0,1,0,1,1,1,1,1,5,1,1,1,1,1,1,1,1,0,1
1,1,1,0,0,0,0,0,0,5,0,0,0,0,0,0,0,1,0,1
1,0,1,1,1,1,1,1,1,5,1,1,1,1,1,1,0,1,0,1
1,0,0,0,0,0,0,0,0,5,0,0,0,0,0,0,0,0,0,1
1,0,1,1,1,1,1,1,1,5,1,1,1,1,0,0,0,1,0,1
1,0,1,0,0,0,0,0,0,5,0,0,0,0,0,2,0,1,0,1
1,0,1,1,0,1,1,1,1,5,1,0,1,2,1,2,1,1,0,1
1,0,0,0,0,0,0,4,0,5,0,P,0,0,0,2,0,0,0,1
1,1,1,1,1,1,1,1,1,1,1,1,1,1,1,1,1,1,1,1
